########################
#      #               #
#      #               #
#      #               #
#      #               #
#      #               #
#      #           a   #
## #####               #
#      #               #
#      ##              #
#       #              #
#       #              #
#       #              #
      ###              #
#                      #
#            a         #
#                      #
#                      #
#              #       #
#              #       #
#              #       #
#              #       #
#              #       #
########### ############
