########################
#     #                #
#     #                #
#  @  #  a         #   #
#     #             #  #
#     #             #  #
#     #             #  #
#     #            ##  #
#                  ##  #
#                  #   #
#            ###########
#                      #
#                      #
#
#                      #
##         #           #
#    # #####           #
#    # #   #           #
#      #               #
#                      #
#                      #
#                      #
#                      #
########################
