########################
#                      #
#                      #
#                      #
#                      #
#                      #
#                      #
#                      #
#                      #
#                      #
#                      #
#                      #
#                      #
#                      #
#                      #
#                      #
#                      #
#                      #
#                #######
#                #     #
#                #     #
#                #     #
#                #     #
######## ######### #####
