########################
#     #                #
#     #            #   #
#     #             #  #
#     #             #  #
#     #             #  #
#     ##           ##  #
#      #           ##  #
#      #           #   #
#            ###########
#                      #
#                      #
#                      #
#                      >
#          #           #
#    # #####           #
#    # #   #           #
#      #               #
#                      #
#                      #
#                      #
#                      #
#                      #
########################
