########### ############
#                      #
#                      #
#                      #
#                      #
#                      #
#                      #
#                      #
#                      #
#                 #    #
#                 ##   #
#             #######      
#                 ##   #
                  #    #
#                      #
#                      #
#                      #
#                      #
#                      #
#                      #
#                      #
#                      #
#                      #
########################
