######## ######### #####
#                      #
#                      #
#                      #
#       ########       #
#      ##      #       #
#              #       #
#      ##      #       #
#       #      #       #
#       ########       #
#                      #
                       #
#                      #
#                      #
#                      #
#                      #
#                      #
#                      #
#                      #
#                      #
#                      #
#                      #
#                      #
########## #############
