########### ############
#                      #
#                      #
#                      #
#                      #
#                      #
#                      #
#                      #
#                      #
#                      #
#                      #
#                      #
                       #
#                      #
#                      #
#                      #
#                      #
#                      #
#                      #
#                      #
#                      #
#                      #
#                      #
########################
