########################
#                      #
#                      #
#                      #
#                      #
#                   #  #
#                   #  #
#                   #  #
                    #  #
#                   #  #
#                   #  #
#                   #  #
#####################
#                   #  #
#                   #  #
                    #  #
#                   #  #
#                   #  #
#                   #  #
#                      #
#                      #
#                      #
#                      #
########################
